20	20
--------------------
--B-------b---------
----1----b3b----2---
----2---b-3-b---1---
----4--b--3--b--3---
----3-----------4---
--------yyyy--------
---444--y44y--444---
--------yyyy--------
--------------------
----2--gg22gg--2----
xxxxxxx------xxxxxxx
--------------------
-----R-rrrrr-R------
-------r111r--------
-----3-r111r-3------
-----3-rrrrr-3------
--------------------
--G-------o-----Y---
--------------------