20	20
-------------------a
-h------------------
--g2gBgg2gg2ggBgg---
--------------------
--------------------
--yyyyyyyyyyyyyyyyy-
--------------------
--------------e-----
--bbRb3bbRYbb3bRbb--
--------------------
----------o---------
--rrrrrrrrrrrrrrrr--
--------------------
--------------------
-ayyGy4yyByy4yyRyy--
-----------h--------
--------------------
--rr1rrbbbbRyyy1ygg-
--------------------
--------------------