20	20
-----R-x------------
-e-----xo-----rr-e--
--g---------x-rr-x--
--ggg--x----x-rr----
----g--x------------
--g-----------------
111111-------4444444
-G---------------B--
1--111-------44444-4
--------------------
--------------------
--33------------444-
----------------xx--
-bbbbb-e----------y-
-bbbb------------yy-
-bbb----Y--e----yyy-
--b------x----yyyyy-
--------------------
------x----------e44
-33-----------------