20	20
-----r--------r-----
----y4r------r4y--R-
---y---r----r---y---
--y-----r11r-----y--
-y-------rr-------y-
y--------gg--------y
--------g22g--------
-------g----g-------
------g--Y---g------
-------g----g-------
--------g22g--------
---------gg---------
---------bb---------
--------b--b--------
-------b----b-------
------b------b------
-----b--------b----G
xxxxxxxxx--xxxxxxxxx
333333--------333333
--------o-----------